Genshin Impact 5
まつざい	松材
まつたけのあわびもどき	松茸のアワビもどき
まつたけのにくまき	松茸の肉巻き
まつたけのばたーやき	松茸のバター焼き
まどうしょろん	魔導緒論
まはーるっかでゔぁーた	マハールッカデヴァータ
まはーゔぁならーなぱな	マハヴァナラーナパナ
まほうのみーとそーす	魔法のミートソース
まめーる	マメール
まらーなのけしん	マラーナの化身
まりあん	マリアン
まりあん・ぎよたん	マリアン・ギヨタン
まる	マル
まるこっとそう	マルコット草
まるしらっく	マルシラック
まるてんすのばんのうほござい	マルテンスの万能保護材
まろうざい	マロウ材
まんえつのみ	満悦の実
まんせいのくさ	蔓生の草
まんせいのけいこく	蔓生の渓谷
まんぞくさらだ	満足サラダ
まんぶんしゅうしゃ	万文集舎
まんまるたこ	マンマルタコ
まーがれっと	マーガレット
まーじょりー	マージョリー
まーせる	マーセル
まーるーと	マールート
みか	ミカ
みかげろしん	御影炉心
みか・しゅみっと	ミカ・シュミット
みじゃーる	ミジャール
みじゅくのぎょくせき	未熟の玉石
みずげんそ	水元素
みずしょうちょう	水晶蝶
みずすらいむ	水スライム
みずふらいむ	水フライム
みずまつりのひと	水祭りの人
みそしる	味噌汁
みつじゅうちゃーしゅー	蜜汁チャーシュー
みどりのかりうどのかんむり	緑の狩人の冠
みどりのかりうどのけっしん	緑の狩人の決心
みどりのかりうどのようき	緑の狩人の容器
みなぎるほしたけ	みなぎる星茸
みぬ	弥怒
みのりゆたか	実り豊か
みひる	ミヒル
みやじ	宮地
みょうじょうさい	明星斎
みらーじゅさいじょう	ミラージュ祭場
みらーめいでん	ミラーメイデン
みるきーきのこくりすぷたわー	ミルキーキノコクリスプタワー
みろえび	美露エビ
みんと	ミント
みんとぜりー	ミントゼリー
みんとのあえもの	ミントの和え物
みんとのけものにくまき	ミントの獣肉巻き
みんとびーんすーぷ	ミントビーンスープ
みんとふるーつてぃー	ミントフルーツティー
みんとべりーじゅーす	ミントベリージュース
みんりん	珉林
みーとそーすらざにあ	ミートソースラザニア
むがくのとう	無学の塔
むくなうみのきんぱい	無垢な海の金盃
むくなうみのぎんぱい	無垢な海の銀盃
むくなうみのくはい	無垢な海の苦杯
むくなうみのしゅはい	無垢な海の酒盃
むくのはな	無垢の花
むこう	無効
むこうのけん	無工の剣
むしょくげんそ	無色元素
むじょうのめん	無常の面
むそうじんはざま	無想刃狭間
むそうのいわ	無相の岩
むそうのかぜ	無相の風
むそうのかみなり	無相の雷
むそうのくさ	無相の草
むそうのこおり	無相の氷
むそうのほのお	無相の炎
むそうのみず	無相の水
むそうらくどのけつまつ	夢想楽土の結末
むほうのけん	無鋒の剣
むぼういんせきみっきゅう	無妄引責密宮
むぼうのおか	無妄の丘
むみょうとりで	無明砦
むめいいせき	無名遺跡
むーんぴあさー	ムーンピアサー
めいうんちょう	明蘊町
めいえんさん	暝垣山
めいかんきょうこく	明冠峡谷
めいかんさんち	明冠山地
めいきのたに	銘記の谷
めいぎょ	冥魚
めいげつのたまご	明月の玉子
めいさいちょう	瞑彩鳥
めいさいとり	瞑彩鳥
めいさいどり	瞑彩鳥
めいとうのつば	名刀の鍔
めいどてん	冥途殿
めかんとる	メカントル
めしつかい	召使
めつじょうのつる	滅諍の蔓
めまいかいひじゅつ・かい	眩暈回避術・改
めらっく	メラック
めりっさ	メリッサ
めりゅしーむら	メリュシー村
めりゅじーぬ	メリュジーヌ
めろぴでようさい	メロピデ要塞
めんてましなりー	メンテマシナリー
めんてましなりー・おうごんとうそつがた	メンテマシナリー·黄金統率型
もううんじんじゃ	曚雲神社
もううんのつき	曚雲の月
もうじゃきょうろ	亡者狭路
もうじゃのみやこ	「亡者の都」
もうじゃのみやこ	亡者の都
もえさかるほのおのまじょ	燃え盛る炎の魔女
もしりさいじょう	モシリ祭場
もしりのから	モシリの殻
もじゃもじゃだじゅう	モジャモジャ駄獣
もな	モナ
もほん	模本
もみじのにわ	紅葉ノ庭
ももよ	百代
もらみーと	モラミート
もるてちく	モルテ地区
もろいこっぺん	脆い骨片
もんたな	モンタナ
もんど	モンド
もんどのかこ	モンドの過去
もんどふうはっしゅどぽてと	モンド風ハッシュドポテト
もんどふうやきざかな	モンド風焼き魚
もん・おとんぬき	モン・オトンヌキ
やえ	八重
やえどう	八重堂
やえみこ	八重神子
やききのこみーとぴざ	焼きキノコミートピザ
やきそば	焼きそば
やくくん	薬君
やくちょうのたに	薬蝶の谷
やこん	夜魂
やこんのかご	夜魂の加護
やこんばーすと	夜魂バースト
やざだはいけ	ヤザダハ池
やしおりじま	ヤシオリ島
やしざい	ヤシ材
やすなゆうきょう	ヤスナ幽境
やぬすのもん	ヤヌスの門
やぶれたはいこつ	毀れた背骨
やまがくれのげいじゅう	山隠れの猊獣
やまさちのめん	山幸の麺
やまもりきのこ	山盛りキノコ
やむちゃしようぜ	飲茶しようぜ！
ゆいいつのしんそう	唯一の真相
ゆうきゅうのげんのがくしょう	悠久の弦の楽章
ゆうきゅうのげんのざんしょう	悠久の弦の残章
ゆうきゅうのげんのだんしょう	悠久の弦の断章
ゆうきゅうのげんのひびき	悠久の弦の響き
ゆうぐれのたいやき	夕暮れの鯛焼き
ゆうぐれのみ	夕暮れの実
ゆうぐれべりーてぃー	夕暮れベリーティー
ゆうこうたいせん	友好対戦
ゆうしのかんむり	勇士の冠
ゆうしのきたい	勇士の期待
ゆうしのくんしょう	勇士の勲章
ゆうしのこころ	勇士の心
ゆうしのそうこう	勇士の壮行
ゆうすいなるちょうこく	幽邃なる彫刻
ゆうやのわるつ	幽夜のワルツ
ゆうゆうだいこうぐん	幽々大行軍
ゆきおおうこきょうのさいご	雪覆う故郷の最後
ゆきのいのしし	雪のイノシシ
ゆきのいのししおう	雪のイノシシ王
ゆくあき	行秋
ゆふぃ	ユフィ
ゆふとぅん	ユフトゥン
ゆみ	弓
ゆみぞう	弓蔵
ゆめ	夢
ゆめのはやし	夢の林
ゆめみざい	夢見材
ゆーふらしあ	ユーフラシア
よいみや	宵宮
ようかい	溶解
ようこうのはま	瑶光の浜
ようごうざん	影向山
ようてつのこさい	熔鉄の孤砦
ようとく	葉徳
ようへいのじゅうけん	傭兵の重剣
ようむのかけら	幼夢の欠片
ようめつのとき	溶滅の刻
よぉーよ	ヨォーヨ
よくじょうのうき	翼状の羽鰭
よげんしゃ	予言者
よごれたかめん	汚れた仮面
よりきぶし	寄騎武士
らいうんのいんろう	雷雲の印籠
らいおんごんげん	雷音権現
らいきんのよきょう	来歆の余響
らいけい	雷蛍
らいけいじゅつし	雷蛍術師
らいこうのぷりずむ	雷光のプリズム
らいさいのせいぞんしゃ	雷災の生存者
らいちょう	雷鳥
らいちょうのあわれみ	雷鳥の憐み
らいていのとけい	雷霆の時計
らいていのねんじゅ	雷霆の念珠
らいでん	雷電
らいでんえい	雷電影
らいでんしょうぐん	雷電将軍
らいでんなしょなる	雷電ナショナル
らいれい	雷霊
らおじ	羅おじ
らくらいのぜんちょう	落雷の前兆
らくらくだじゅう	ラクラク駄獣
らざんがーでん	ラザンガーデン
らしゅぬ	ラシュヌ
らずべりー	ラズベリー
らずべりーみずまんじゅう	ラスベリー水まんじゅう
らたとぅいゆ・たっせす	ラタトゥイユ・タッセス
らっか	落霞
らっきーかーどこいん	ラッキーカードコイン
らどみーる	ラドミール
らな	ラナ
らのーる	ラノール
らふまん	ラフマン
らわっと	ラワット
りおせすり	リオセスリ
りかーぶぼう	リカーブボウ
りくつぜめ	理屈責め
りさ	リサ
りさ・みんつ	リサ・ミンツ
りしゃこう	璃沙郊
りしゅぼらんとら	リシュボラン虎
りしゅぼらんとらのらーじゃ	リシュボラン虎のラージャ
りすいじょうざんしんくん	理水畳山真君
りそうてきじょうきょう	「理想的状況」
りつほん	立本
りとう	離島
りね	リネ
りねっと	リネット
りのれあ	リノレア
りふぁえっと	リファエット
りふぃーちく	リフィー地区
りゅううんしゃくふうしんくん	留雲借風真君
りゅうおう	龍王
りゅうおうのかんむり	龍王の冠
りゅうけつをあびたけん	龍血を浴びた剣
りゅうげつ	流月
りゅうげつのはり	流月の針
りゅうごろしのえいけつたん	龍殺しの英傑譚
りゅうさうなぎ	流砂ウナギ
りゅうしめん	龍髭麺
りゅうみんのたに	龍眠の谷
りゅどひか・しゅないつぇふな	リュドヒカ・シュナイツェフナ
りょういのはね	良医の羽
りょうしとーすと	漁師トースト
りょうてけん	両手剣
りょうへいのかたな	猟兵の刀
りょどうのけん	旅道の剣
りよんえりあ	リヨンエリア
りりあ	リリア
りりす	リリス
りるのかんししゃ	凛流の監視者
りるぱぁーる	リルパァール
りろーる	リロール
りんぐぼう	リングボウ
りんご	リンゴ
りんじほんこう	臨時本坑
りーゆぇ	璃月
りーゆぇこう	璃月港
りーゆぇさんし	璃月三糸
りーゔぁ	リーヴァ
るか	ルカ
るきなのいずみ	ルキナの泉
るね・ど・ぺとりこーる	ルネ・ド・ペトリコール
るぽーととけいてん	ルポート時計店
るみどぅーすはーばー	ルミドゥースハーバー
るりてい	琉璃亭
るりほう	琉璃峰
るろうがくしょう	流浪楽章
るろうしゃのまんかいのはな	流浪者の満開の花
るー	ルー
るーめら	ルーメラ
れいえん	霊淵
れいくかん	霊矩関
れいくのにわ	霊枢の庭
れいこう	霊光
れいこうかげろう	霊光カゲロウ
れいこうひゃくしゅ	霊光百種
れいしん	霊芯
れいじん	冷刃
れいせいせんにく	冷製鮮肉
れいせいにくもりあわせ	冷製肉盛り合わせ
れいめいのしんけん	黎明の神剣
れいもうさん	霊濛山
れいら	レイラ
れいんどっと	レインドット
れきせんのしゅりょうゆみ	歴戦の狩猟弓
れきせんのやさき	歴戦の矢先
れざー	レザー
れしゅっつのくろっくわーくこうぼう	レシュッツのクロックワーク工房
れっかをわたるけんじゃ	烈火を渡る賢者
れっしぐ・ろーれんす	レッシグ・ローレンス
れっちゅうすなはら	列柱砂原
れっぷうのじゅうしゃ	烈風の従者
れつかいか	烈開花
れつじつのこうし	烈日の後嗣
れでぃどっぐ	レディドッグ
れもでぃえーる	レモディエール
れりる	レリル
れんじげーじ	レンジゲージ
れんぶひきょう	煉武秘境
ろあるて	ロアルテ
ろう	ロウ
ろうが	狼牙
ろうこなやさき	牢固な矢先
ろうちゃじゅのおか	老茶樹の丘
ろかのむかしがたり	炉火の昔語り
ろくかのいけ	漉華の池
ろさりあ	ロサリア
ろざりん・くるーずちか・ろーえふぁるた	ロザリン・クルーズチカ・ローエファルタ
ろっくだんごぎゅうにゅう	ロック団子牛乳
ろはうぇい	ロハウェイ
ろまりたいむはーばー	ロマリタイムハーバー
ろれんつぉ	ロレンツォ
ろーうぃっく	ローウィック
ろーかぱーらみつりん	ローカパーラ密林
ろーずしゅりかんど	ローズシュリカンド
ろーぜる	ローゼル
ろーでしあ	ローデシア
ろーる	ロール
ろーるふぇーず	ロールフェーズ
わかたけに	若竹煮
わかみず	若水
わかむらさき	若紫
わくかうはま	ワクカウ浜
わすれられしみち	忘れられし道
わたつみじま	海祇島
わにのほしにく	ワニの干し肉
わはくえん	和璞鳶
わひっど	ワヒッド
わーぐなー	ワーグナー
んじぇりっくあぷりしあ	アンジェリックアプリシア
ゔぁいんしょっと	ヴァインショット
ゔぁざーりかいろう	ヴァザーリ回廊
ゔぁしぇ	ヴァシェ
ゔぁならーな	ヴァナラーナ
ゔぁねっさ	ヴァネッサ
ゔぁるな	ヴァルナ
ゔぁーじる	ヴァージル
ゔぁーでぃくとでぃなー	ヴァーディクトディナー
ゔぃくとりあ	ヴィクトリア
ゔぃくとる	ヴィクトル
ゔぃくらむ	ヴィクラム
ゔぃしゃっぷけんきゅうじょ	ヴィシャップ研究所
ゔぃしゃっぷ・いわ	ヴィシャップ・岩
ゔぃしゅっだへんど	ヴィシュッダ辺土
ゔぃなやっく	ヴィナヤック
ゔぃまらむら	ヴィマラ村
ゔぃるまんと	ヴィルマント
ゔぇずるふぇるにる	ヴェズルフェルニル
ゔぇにーる	ヴェニール
ゔぇる・ごれっと	ヴェル・ゴレット
ゔぇるー	ヴェルー
ゔぇるーりや・みらーじゅ	ヴェルーリヤ・ミラージュ